HHHHHHHHHHHHHHS
V CCBCCCCCBCC V
HHHCCCCBCCCCHHH
VBV CCCCCCC VBV
VCHHHCCCCCHHHCV
VCCBV CCC VBCCV
VCCCHHHCHHHCCCV
VCCCC V V CCCCV
VCCCCCV VCCCCCV
HHHHHHHHHHHHHHH
