SHHHHH  B B  HS
 CC  V       V
 CC  V CCCCC V
BCCB V CCCCC V
CCCC V       V
CCCC V B  HHHH
 CC  V CC V
 BB  VCCCCV CC
C    V CC V CC
CC   HHHHHH
