SHBCCCCBCCCCBHS
CV  CCCCCCC  VC
CHHH CCCCC HHHC
C  V  CCC  V  C
   HHH C HHH
  B  V B V  B
  C  VCCCV  C
 CCC HHHHH CCC
CCCCC CVC CCCCC
CCCCC CHC CCCCC
