SHHHHHHHHHHHHHS
VCBCCV V VCCBCV
VCCC VBVBV CCCV
VCCCHH V HHCCCV
VCC V CVC V CCV
VCCHH CVC HHCCV
VC V CCVCC V CV
VCHHBCCVCCBHHCV
VCVCCCCVCCCCVCV
HHHHHHHHHHHHHHH
