SHCCCCCVCCCCCHS
 VCBCBCVCBCBCV
BVCCCCCVCCCCCVB
CHHCCCCVCCCCHHC
CCV CCCVCCC VCC
CCHHHCCVCCHHHCC
CCCCV CVC VCCCC
CCCCHH V HHCCCC
CCCCCV V VCCCCC
CCCCCHHHHHCCCCC
